..............................
..............................
..............................
..............................
..............................
..............................
..............................
..............................
..............................
..............................
..........####................
......................####....
........C.........C......C....
.P....F.....G.......G.......E.
##############################
