....................
....................
....................
....................
....................
....................
....................
....................
....................
...............G....
....................
....................
....................
....................
####################
