....................
....................
....................
....................
....................
....................
....................
....................
....................
.....####...........
....................
............C.......
.....C..............
.P....I...G....G..E.
####################
